111111111111111111111111111111
1C0001C10000C1000000001000C1C1
101100000011CC000100101C010001
10CC0111C1C001110010001C10C001
10110001000010001001001C100101
1000001C011001000000101C10C101
11C001P100C100000010001C110001
110000C011C1001000000CC0000C11
10C10000C000000000110000000011
1011110101111C0000100011001011
1C01000101000C1000000000E01001
11000000CC0010110000C110000C11
111111111111111111111111111111